1111111131111111
1..............1
1..1......1....1
1..1......1....3
4..............1
1.....1......111
1.....1......2.9
1.....a......111
1111311511411111
