1111111111111111
1..............5
1..............1
1...3333333....1
1...3.....3....1
1...3..4..3....1
1...3..9..3....1
1...3332333....1
1..............1
5..............1
1111111111111111
