1111111111111111
1..............5
1..............1
3...1111111....1
1...1.....1....1
1...3..4..1....1
1...1..9..1....2
1...1112111....1
1..............1
5......f.......1
1111111111111111
